{
  "boardSize": { "height": 8, "width": 8 },
  "board": [
    [
      { "id": 1 },
      { "id": 0 },
      { "id": 3 },
      { "id": 3 },
      { "id": 3 },
      { "id": 0 },
      { "id": 0 },
      { "id": 11 }
    ],
    [
      { "id": 11 },
      { "id": 11 },
      { "id": 11 },
      { "id": 11 },
      { "id": 11 },
      { "id": 11 },
      { "id": 1 },
      { "id": 11 }
    ],
    [
      { "id": 3 },
      { "id": 3 },
      { "id": 3 },
      { "id": 14 },
      { "id": 3 },
      { "id": 4 },
      { "id": 12 },
      { "id": 11 }
    ],
    [
      { "id": 5 },
      { "id": 8 },
      { "id": 8 },
      { "id": 8 },
      { "id": 8 },
      { "id": 8 },
      { "id": 8 },
      { "id": 11 }
    ],
    [
      { "id": 1 },
      { "id": 13 },
      { "id": 3 },
      { "id": 3 },
      { "id": 4 },
      { "id": 4 },
      { "id": 4 },
      { "id": 11 }
    ],
    [
      { "id": 8 },
      { "id": 8 },
      { "id": 8 },
      { "id": 8 },
      { "id": 8 },
      { "id": 0 },
      { "id": 0 },
      { "id": 11 }
    ],
    [
      { "id": 0 },
      { "id": 4 },
      { "id": 4 },
      { "id": 4 },
      { "id": 4 },
      { "id": 4 },
      { "id": 4 },
      { "id": 11 }
    ],
    [
      { "id": 1 },
      { "id": 11 },
      { "id": 11 },
      { "id": 11 },
      { "id": 11 },
      { "id": 11 },
      { "id": 11 },
      { "id": 11 }
    ]
  ],
  "levels": [1, 2, 3, 4, 5, 6, 7],
  "levelID": 1
}
